NO ./textures/test.png
WE ./textures/test1.png
SO ./textures/test2.png
EA ./textures/test3.png

F 50,50,50
C 225,30,-20

1111111111111
1001000000001
1000011111001
100011E000001
1111111111111
