11111111111111111111111111111111
10000000000000000000000000000000111
11111000000000000000000000000001
10000100000000000000000000000001
10001000000000000000000000000001
10111000000000000000000000000001
10111000000000000000110000000001
10000100000000000001000000000001
100000000N0000110001000000000001
11111111111111111111111111111111
