11111111111111111111111111111111111111111111111111
11010111111011100110110011001010111100011100111101
10001001101100101010101011101001001100000011001001
10010100110010110101111110010110010010001100111001
11110011011010010011001111100001010011011110101101
10010101000100000011011100110011010110010001101111
10011101011010111100010010101110101111010101110111
11110111010101111001110100000011100101100110000001
10111100000001101111001110100100011101101100010001
11110101111011010001101110101100011001000101100101
11001010000110110000100010101001101000000101111101
11011010111011101100100010110000101011100001111001
11001101110100111100010010101000110000111111001111
11110111101001010000010011111001110100010111100101
10010011100010101001000001111000001000W10101110011
10110100111010000101100010110111111001010000000001
10110010011000001100001001000010101101110010110001
10001011110101111100001000010100101000001011110001
11001101001011011110110111000110010110011110011011
11000010100011011100101000101000101000000001000111
10111011001110000101101011111001010111010001001011
10110011100100011000111110010010011010010001100001
10111010011111110001000000110100010111000110001001
11001000101111010010110101111111011001011101100101
11111111111111111111111111111111111111111111111111
