C 73,250,186
F 124,237,3
1111111111111111111111111
1011011111110010101001001
1010010010100010101101011
1010110110011011110101001
1001111001100001110100011
1101000001010100101001001
1110010001001001011001001
1000011110010011001010101
1001000111111000111011101
1110000100101000111010011
1110011111111110001011011
10000101000101011100N0001
1111111111111111111111111
