1111111111111111111111111
1100100110110110110000111
111101001011111000100N101
1000001010100011110101001
1001000111011001000010101
1000101101001001111111101
1101011111010000100110101
1011101000010110000110011
1101011001110101111111011
1101110101110010001010001
1111010000101000111011111
1000010010000111110100101
1111000100100011111010101
1100101000110010001000111
1100100000011001001111111
1110110110111100000111101
1111100011101000101101101
1110001101000100001011111
1110011110000011000001101
1111001110010011111101111
1111000100000011111011101
1111010101101100100100011
1111000101010111010001011
1111010111001101101101011
1111111111111111111111111
