C 73,52,165
F 176,90,188
1111111111111111111111111
1011101W01110111011010011
1101011011100111111010111
1000001010000110011011011
1010100010100111011101001
1110011001100101100101011
1111010101001111100110101
1110001010101100100110011
1101111010010000110001001
1000100110101101001011011
1111110110001000100111111
1100110001100101011001111
1111111111111111111111111
