C 194,69,120
F 128,121,159
11111111111111111111111111111111111111111111111111
11000001011100011011101001011010010010010110111011
11101111011000001100101110101101001110110010000111
10101000111001101100110111111100011111100011001111
11010001100110111001101000101000001000010001101001
11101100110010110000000000010101011001000001111101
11001011011101000101001011101011111010001111010001
10101000010101011100000111110110110010010000001101
11101010101011010111101101100110010011000001110101
10010110101110101100001001010000010001111001011001
110111101111000010111010S1101001110100111011010111
11101001101000001011001000111100010110010011011101
10000100101010001011100101001111111110000111111101
11011001111000101110111110001011110011110010010101
10011100101000010011100100001001000010000101000011
10100001001101011010010011111010001001101111010011
11011100011110010101011101010110011101101000000111
10011100001110101010010110100111110100111000010111
10111000000111010101110010111100100000100110101111
11000011000110010010001100110001110111001010011111
11101011100101110101001101100110010111101101010001
10000110000110111110001111000000000001001011000111
11111111111111111111111111111111111111111111111111
