11111111111111111111111111111111111111111111111111
10100000010111111000101110011000110111110001110011
11111001110010101111010111000110001101010100110101
10011000100011011110011101100111110010010110011001
10000110100101010000001110101001101111101001101011
11011101111001111000111111011110010000110010101001
11000110011010011011100101111011101110100001000111
10000011100000010101001001110101111010110110111111
11111010001011110010001010010101010001001100011111
10110010011001101101001111000111000001000110100001
11101001101110010000100101110110000000110000001001
11010000011000010010101101101101000000001101100111
11101011111001101110110011001000010100111001011111
10100011111011111111100000100101111110001011100011
11111010010000110111110111011010011111110000011001
10000011110010011010101101111011111110001101110011
11000110101001110100110101010011011000010010110101
10111001100111010111110110101101010111101110111101
10010101100010111111001011000001000011001000010111
11011010101101001111011110111100010111001111000111
11010001010110011010110100000011100100001010110011
11110100100111001001001011000000111111101100101011
110111100001011000111100E0110001101010100111001101
10011010001101011101011000110000101010011001111101
11111111111111111111111111111111111111111111111111
