C 75,148,83
F 21,148,126
1111111111111111111111111
1100000011000110110100111
1010000001101101001001001
1010100110011011100110001
1000101101001010110100001
1110100111110101111100001
1100001100011010101000011
1101101110111E00010100111
1010001110101111000010011
1111001111110101010101011
1000010001010011100001111
1001101101001101001101011
1111111111111111111111111
