NO ./textures/test.png
SO ./textures/test.png
WE ./textures/test1.png
EA ./textures/test1.png
C 247,118,221
F 14,20,219
1111111111111111111111111
1011101100101100111100011
1000001011100011010001011
1010100110000011100100111
1001011001001000110110001
1101101010010101111101011
1011000011100110111000011
1010101111001100001000111
1110110100100111000001101
1111111001100010N11010111
1001000101010000010100001
1111111101111111101001001
1111111111111111111111111
