1111111111111111111111111
1100000010011100000110101
1110101110111111010001011
1101011010100111110001001
1010001010001011100100011
1101100100100110001011101
1010010001011100101010111
1010001000110110111100101
1110100101001101101000001
1111011111110101110001001
1001101100001110001011001
1010011010001010100111011
1111100100011001100010111
1111000100011011011101001
1100100010010011011111001
1001101100001011111010011
1010000000001111111001111
1001111101011110110101011
1110111010001110000101001
1110010111010010110101001
1100000W01111110001101001
1010111111101000011100011
1000001001000101110100101
1100000111111001011111101
1111111111111111111111111
