11111111111111111111111111111111111111111111111111
11011111010011000111000110001001000111010010110101
11100111101001101010101000001011000011101010100001
10000100100000100100110011000100100110100001001011
10001111011000110100000001101100111N00101110101111
10110000110000011101110101111010000000011010101011
11011001111010000001010010000111110010101001001111
11010010010011000001111001100011010000001110010111
10000010100110011111100011110101010011001000001011
11101110001010011010110000101000101010000001001101
10110100010111111010000001001110101111110000101001
10010110010101101111010111101001000110111010100111
11000011101001000011011010000010110001111101001001
11010111111111100100000110010000101110001110011101
11111100110110000111011100011100011011000001001011
10111010111001000101110110100001101000011101001101
10011000010001011111101011101011010101000010111001
11011110000101111101001110101111010101101010101001
11100111111100001111001001001101000011100110100111
11010010110001011010110000010101010010101100001101
10101001001011100101111110110011001001101001011011
11001110101000111011100010110011011111101000111011
10100111000010111000111111101000001010010011000011
10001111101000000111111010101000000000110011011011
11111111111111111111111111111111111111111111111111
