C 1,42,43
F 80,95,42
1111111111111111111111111
1000100110000011110011011
1101111111111000100100001
1010011000010011100110111
1111010010010111111111001
1101001111011110110011101
1010101110000011101001101
1000001001101100000010001
1000001001001011110100101
1001111111110000010111001
1011111101110001101101101
11100011010110S0001101101
1111111111111111111111111
